#             #
#B########### #
############# #
#             #
# ########### #
#            A#
###############